###...###
#.......#
#.......#
....#....
...#@#...
....#....
#.......#
#.......#
###...###